111111
1C0001
100P01
1C01E1
111111