1111111111111111111
1P00000C000C00000E1
1011110101110101111
1C000001000100000C1
1111011110111101111
1C000C000C000C000C1
1011101111111011101
1C000001000100000C1
1111011101110111011
1C0000C0000C0000C01
1111111111111111111