1111111111
1C0P001111
100E000C11
1111111111